2,1,2,1,2,1,2,2,0,0,2,2,2,2,2
0,2,2,2,2,0,0,0,2,0,1,2,1,0,1
0,1,2,1,2,1,2,0,0,1,2,2,0,0,0
0,0,2,2,2,0,0,2,2,0,1,2,1,2,1
2,1,2,1,2,1,2,0,0,1,2,2,2,2,2
2,2,2,2,2,0,0,0,2,0,1,2,1,2,1
2,1,2,1,2,1,2,2,0,0,2,2,2,2,2
1,0,1,0,1,0,0,0,2,0,1,0,1,0,1
2,2,2,2,2,0,2,0,0,1,2,1,2,1,2
1,2,1,2,1,0,0,2,2,0,2,2,2,2,2
2,2,2,2,2,1,2,0,0,1,2,1,2,1,2
1,0,1,2,1,0,0,0,2,0,2,2,2,2,0
0,0,2,2,2,1,2,2,0,1,2,1,2,1,0
1,0,1,2,1,0,0,0,2,0,2,2,2,0,0
2,2,2,2,2,0,2,0,0,1,2,1,2,1,2

2,5,2,5,2,7,4,4,0,0,1,2,1,2,1
0,2,1,2,1,0,0,0,4,0,6,1,6,0,6
0,5,4,5,4,7,4,0,0,7,1,2,0,0,0
0,0,2,1,2,0,0,4,4,0,6,4,6,4,6
4,5,4,5,4,7,4,0,0,7,2,1,2,1,2
1,2,1,2,1,0,0,0,4,0,6,4,6,4,6
2,5,2,5,2,7,4,4,0,0,1,2,1,2,1
7,0,7,0,7,0,0,0,4,0,7,0,7,0,7
1,2,1,2,1,0,4,0,0,7,1,5,1,5,1
6,4,6,4,6,0,0,4,4,0,2,1,2,1,2
2,1,2,1,2,7,4,0,0,7,4,5,4,5,4
6,0,6,4,6,0,0,0,4,0,1,2,1,2,0
0,0,1,2,1,7,4,4,0,7,4,5,4,5,0
6,0,6,1,6,0,0,0,4,0,2,1,2,0,0
1,2,1,2,1,0,4,0,0,7,1,5,1,5,1

0,0,0,0,0,0,5,4,5,0,0,0,0,0,0
0,0,0,0,0,0,5,4,5,0,0,0,0,0,0
0,0,0,0,0,0,5,4,5,0,0,0,0,0,0
0,0,0,0,0,0,1,1,1,0,0,0,0,0,0
0,0,0,0,0,0,5,4,5,0,0,0,0,0,0
0,0,0,0,0,0,5,4,5,0,0,0,0,0,0
0,0,0,0,0,0,5,4,5,0,0,0,0,0,0
0,0,0,0,0,0,5,4,5,0,0,0,0,0,0
0,0,0,0,0,0,5,4,5,0,0,0,0,0,0
0,0,0,0,0,0,5,4,5,0,0,0,0,0,0
0,0,0,0,0,0,5,4,5,0,0,0,0,0,0
0,0,0,0,0,0,1,1,1,0,0,0,0,0,0
0,0,0,0,0,0,5,4,5,0,0,0,0,0,0
0,0,0,0,0,0,5,4,5,0,0,0,0,0,0
0,0,0,0,0,0,5,4,5,0,0,0,0,0,0
