1,1,1,1,0,0,0,2,0,0,0,1,1,1,1
1,1,1,2,0,1,2,0,2,1,0,2,1,1,1
1,1,2,2,0,0,0,2,0,0,0,2,2,1,1
1,2,2,2,2,1,2,0,2,1,2,2,2,2,1
0,0,5,2,2,0,0,2,0,0,2,2,0,0,0
0,1,2,1,2,1,2,0,2,1,2,1,2,1,0
2,2,2,2,2,2,0,2,0,2,2,2,2,2,2
2,1,2,1,2,1,2,0,2,1,2,1,2,1,2
2,2,2,2,2,2,0,2,0,2,2,2,2,2,2
0,1,2,1,2,1,2,0,2,1,2,1,2,1,0
0,0,0,2,2,0,0,2,0,0,2,2,4,0,0
1,2,2,2,2,1,2,0,2,1,2,2,2,2,1
1,1,2,2,0,0,0,2,0,0,0,2,2,1,1
1,1,1,2,0,1,2,0,2,1,0,2,1,1,1
1,1,1,1,0,0,0,2,0,0,0,1,1,1,1

5,6,5,6,0,0,0,4,0,0,0,6,5,6,5
6,5,6,2,0,7,4,0,4,7,0,2,6,5,6
5,6,2,1,0,0,0,4,0,0,0,1,2,6,5
6,2,1,2,1,7,4,0,4,7,1,2,1,2,6
0,0,0,1,2,0,0,4,0,0,2,1,0,0,0
0,5,4,6,1,7,4,0,4,7,5,6,4,5,0
1,2,1,2,1,2,0,4,0,2,1,2,1,2,1
4,6,1,5,2,7,4,0,4,7,2,5,1,6,4
1,2,1,2,1,2,0,4,0,2,1,2,1,2,1
0,5,4,6,1,7,4,0,4,7,5,6,4,5,0
0,0,0,1,2,0,0,4,0,0,2,1,0,0,0
6,2,1,2,1,7,4,0,4,7,1,2,1,2,6
5,6,2,1,0,0,0,4,0,0,0,1,2,6,5
6,5,6,2,0,7,4,0,4,7,0,2,6,5,6
5,6,5,6,0,0,0,4,0,0,0,6,5,6,5

0,0,0,0,0,0,5,4,5,0,0,0,0,0,0
0,0,0,0,0,0,5,4,5,0,0,0,0,0,0
0,0,0,0,0,0,5,4,5,0,0,0,0,0,0
0,0,0,0,0,0,5,4,5,0,0,0,0,0,0
0,0,0,0,0,0,1,1,1,0,0,0,0,0,0
0,0,0,0,0,0,5,4,5,0,0,0,0,0,0
0,0,0,0,0,0,5,4,5,0,0,0,0,0,0
0,0,0,0,0,0,5,4,5,0,0,0,0,0,0
0,0,0,0,0,0,5,4,5,0,0,0,0,0,0
0,0,0,0,0,0,5,4,5,0,0,0,0,0,0
0,0,0,0,0,0,1,1,1,0,0,0,0,0,0
0,0,0,0,0,0,5,4,5,0,0,0,0,0,0
0,0,0,0,0,0,5,4,5,0,0,0,0,0,0
0,0,0,0,0,0,5,4,5,0,0,0,0,0,0
0,0,0,0,0,0,5,4,5,0,0,0,0,0,0
